S  ######################################################################################################################
         #        #     #           #        #              #  #  #                 #     #     #     #           #  #  #
#  #######  #######  #  #  ##########  #  ####  ##########  #  #  #######  ####  ####  ####  #  #  ####  ####  #  #  #  #
#     #              #     #  #  #  #  #     #  #           #  #        #  #     #        #  #        #     #  #     #  #
####  #  #  ####  ####  #  #  #  #  ####  ####  ####  ####  #  #######  ####  #  #  #  ####  #######  #  ##########  #  #
#  #  #  #     #  #  #  #  #  #  #     #     #  #  #     #     #              #     #  #  #  #     #        #     #     #
#  #  #######  ####  ####  #  #  #  #######  ####  #  ####  #  ####  ####  ##########  #  ####  #  #  ####  #  #  #  ####
#  #           #     #        #     #                 #     #  #  #     #  #  #  #  #           #        #     #  #     #
#  ####  ####  ####  ####  ####  ####  #######  ################  ####  ####  #  #  #######  ######################  #  #
#        #     #  #  #  #  #     #     #  #     #     #  #  #     #  #  #                 #                       #  #  #
#  ####  #  #  #  #  #  ####  ####  #  #  #######  ####  #  ####  #  ####  ####  #######  #  ####  ###################  #
#  #     #  #     #  #     #  #     #     #     #        #  #  #     #        #  #  #     #  #     #  #        #        #
#############  ####  #  ####  #  ##########  #  ####  #  #  #  #  #############  #  #######  #  ####  ####  ####  #######
#  #           #  #              #  #     #  #     #  #           #                          #           #  #     #  #  #
#  ####  ####  #  #  ####  #######  #  ##########  #  ####  #######  #  ####  #  #######  #  #  ####  #  #  #  ####  #  #
#  #     #     #        #     #  #                    #  #  #        #     #  #  #        #  #     #  #  #  #     #  #  #
#  #  #######  #  #  #######  #  #############  ####  #  ####  ####  #############  ####  #######  #######  #######  #  #
#        #        #        #        #  #           #     #     #  #     #        #     #     #     #        #           #
#  ####  #######  #############  #  #  #  ################  #  #  #  #  #######  #############  #  #  #  ####  #######  #
#  #  #  #     #  #  #     #  #  #  #           #     #  #  #  #  #  #  #     #           #     #  #  #        #  #     #
#  #  #  #  #  #  #  #  #  #  ####  ##########  #  #  #  ####  #  #######  ##########  #  #######  #############  ####  #
#     #  #  #     #  #  #     #     #     #     #  #                          #        #     #           #              #
#  ####  ##########  ####  #######  #  #  ####  ####  #  #  #######  ###################  #############  #  ####  #######
#  #  #  #                    #     #  #     #     #  #  #  #        #                       #  #     #  #  #  #  #     #
####  #######  #  ####  #######  #  ####  #  ####  ################  #######  ##########  ####  #  #  #  #  #  #######  #
#     #        #     #        #  #  #  #  #     #        #        #     #     #                    #        #     #     #
#  #######  ####  #  #  ####  #  #  #  #  #  ####  #  #######  #  #  ##########  #######  #  #  #######  #  ####  #  #  #
#  #  #        #  #  #     #  #  #     #  #  #     #     #     #     #     #  #     #     #  #  #  #  #  #     #     #  #
#  #  #  ####  ####  #  #  #######  ####  ##########  ####  #############  #  #  #  #############  #  #  #  #######  ####
#  #        #     #  #  #  #  #     #     #           #              #  #  #  #  #  #  #                 #           #  #
#  ####  #  #######  #######  ####  ####  ####  ####  ####  ##########  #  #  #######  #  #  ####  ####  #  ####  #  #  #
#  #  #  #  #  #                    #           #     #        #        #     #     #  #  #  #        #  #     #  #     #
#  #  #######  ####  ####  #######  #  #  #############  #  #  #  #  ####  #  #  ####  #  #  #  #  #  ################  #
#     #           #  #     #        #  #  #  #           #  #     #     #  #     #     #  #  #  #  #  #     #  #        #
#  #  ##########  #  #  #############  ####  ####  #######  #  #############  #  #  #  ####  #  #  #  #  #  #  ####  ####
#  #  #  #           #     #        #  #  #  #  #  #     #  #  #  #        #  #  #  #        #  #  #     #        #     #
####  #  #  #  #  #  #  ####  #######  #  #  #  #  #  #  #  ####  #######  #  ##########  ####  ####  #######  #######  #
#  #        #  #  #  #  #     #  #  #        #        #  #        #     #                 #  #  #           #  #     #  #
#  #############  #  #  ####  #  #  #######  #######  #######  #######  #  #############  #  #  ####  #######  ####  ####
#                 #  #  #  #        #     #     #     #     #     #  #              #        #  #        #     #  #     #
#  #  ####  #######  ####  ####  ####  ####  #######  ####  #  ####  #######  ##########  ####  #######  #######  ####  #
#  #  #     #  #     #     #     #                    #     #     #                    #  #     #           #           #
####  #  #  #  #######  ####  #  ####  ####  #  #  #  #  #  ####  #  ####  #############  #  #  ####  #######  #  ####  #
#  #  #  #  #     #     #     #           #  #  #  #     #  #  #  #  #  #  #              #  #  #  #  #  #     #  #     #
#  ####  #  #  ####  #  ####  ####  #######  ################  #  #  #  #  ####  #######  #######  ####  ####  #######  #
#        #        #  #     #  #  #        #  #  #  #        #  #  #     #  #  #     #  #  #        #           #  #     #
#  #######  ##########  ####  #  ####  #######  #  #######  #  #  ##########  #  ####  ##########  #  #  ####  #  #######
#     #              #     #  #  #     #     #     #     #  #              #     #     #     #  #     #     #     #  #  #
#  #  #######  ####  #  ####  #  ##########  #  ####  ####  ####  #  #######  #  ####  ####  #  #  ####  #  #######  #  #
#  #  #  #        #     #           #  #                 #  #  #  #  #        #  #              #  #     #  #     #     #
####  #  #  #  #  ####  ##########  #  #######  ####  ####  #  ##########  #  #  ####  #######  #######  ####  ####  ####
#     #     #  #  #        #                 #     #  #  #  #     #  #     #  #           #        #     #  #  #  #     #
###################  #######  #  ####  #######  #  #  #  #  #  ####  #  #  ####  #  #  #######  #  #  ####  #  #  ####  #
#  #  #  #     #  #     #     #  #  #        #  #  #     #  #  #        #  #     #  #  #     #  #     #  #              #
#  #  #  #  #  #  #  #############  #  ####  ####  ####  #  #  #  ####  ####  ##########  ####  ####  #  ####  #######  #
#     #  #  #  #     #  #     #  #     #     #     #        #     #        #  #  #  #     #  #  #  #  #  #     #        #
#  #  #  #  ####  ####  #  ####  #  #  ####  #############  #######  #  #  ####  #  ####  #  #  #  #  #  #  #  #######  #
#  #           #  #           #     #     #     #        #  #        #  #     #  #        #     #     #  #  #  #  #  #  #
####  ####  #  #  ##########  #  #  #############  #  #  #  #######  ####  ####  #  ####  #  ####  ####  #  #  #  #  #  #
#     #  #  #  #                 #  #        #     #  #     #           #  #     #  #     #  #     #     #  #  #        #
#######  #  ###################  ##########  #############  #  ####  #######  ####  ####  #  ####  #  ################  #
#        #     #     #     #     #           #        #        #  #     #  #  #  #  #        #     #     #              #
####  #######  #  ####  #######  ####  ##########  ##########  #  ####  #  #  #  #############  ####  #######  #  #  #  #
#     #        #     #     #     #     #     #                       #     #     #           #           #     #  #  #  #
#  #######  #  #  ####  ####  #  #  #  ####  #  #############  ####  ####  ####  #  ####  ####  #  ###################  #
#           #                 #  #  #  #  #     #  #     #        #  #     #  #     #     #  #  #  #                 #  #
##########  ####  #  #  #  ####  ####  #  #######  #  #  #  ##########  #  #  ##########  #  #  ################  ####  #
#           #     #  #  #  #     #     #  #  #        #  #     #     #  #                    #  #              #        #
#  #  #######  ####  ##########  #  #  #  #  #  #  ####  #  #  #  ####  #########################  ####  ##########  ####
#  #  #           #           #  #  #        #  #  #        #  #     #        #  #     #           #                 #  #
#  ##########  ####  ################  #  #  #  ####  ####  #  #  ##########  #  #  #  #  ###################  #  #  #  #
#  #           #     #           #  #  #  #     #     #     #     #        #  #  #  #  #           #  #  #     #  #     #
#######  ##########  #  ####  #  #  #  #  #  #  ####  ###################  #  #  #  ####  #######  #  #  #  #############
#  #     #  #           #     #     #  #  #  #     #  #  #     #     #     #           #  #  #        #              #  #
#  #  ####  ####  ####  ####  ##########  ##########  #  ####  ####  ####  #  ####  #  ####  #  #  ####  #  #  #  #  #  #
#        #     #  #  #  #        #  #        #  #           #  #     #     #  #     #     #  #  #     #  #  #  #  #  #  #
#  ####  #  #  ####  #  ####  #  #  ####  ####  #  #  #  ####  ####  ####  ####  #######  #  ##########  #######  ####  #
#     #     #  #     #  #     #  #           #  #  #  #     #              #        #        #     #        #           #
#  ####  #######  ####  ####  #  #  #  ####  #  #  #  ####  ####  ####  #  ####  #############  ####  #  ####  ####  ####
#     #        #        #     #  #  #     #     #  #     #  #        #  #                             #  #     #        
######################################################################################################################  E